8 8
trader_room_v1_entities.csv
10,10,10,10,10,10,10,10
10,8,8,8,8,8,8,10
10,8,8,8,8,8,8,10
10,8,8,8,8,8,8,10
10,8,8,8,8,8,8,10
10,8,8,8,8,8,8,10
10,8,8,8,8,8,8,10
10,10,10,8,8,10,10,10
