9 9
exit_entities.csv
31,31,31,35,35,35,31,31,31
31,35,35,35,35,35,35,35,31
31,35,35,35,35,35,35,35,31
35,35,35,35,35,35,35,35,35
35,35,35,35,35,35,35,35,35
35,35,35,35,35,35,35,35,35
31,35,35,35,35,35,35,35,31
31,35,35,35,35,35,35,35,31
31,31,31,35,35,35,31,31,31
