20 10
start_entities.csv
41,27,27,27,27,27,27,27,27,27,27,27,27,27,27,27,27,27,27,41
28,0,0,0,0,0,0,0,0,40,40,0,0,0,0,0,0,0,0,29
28,0,0,0,0,0,0,0,40,40,40,40,0,0,0,0,0,0,0,29
28,0,0,0,0,0,0,0,0,40,40,0,0,0,0,0,0,0,0,29
28,0,0,1,0,0,0,0,0,0,0,0,0,0,0,0,1,0,0,29
28,0,0,1,1,1,1,1,1,1,1,1,1,1,1,1,1,0,0,29
28,0,0,0,0,0,0,0,0,0,0,0,0,0,0,0,0,0,0,29
28,0,0,0,0,0,0,0,0,0,0,0,0,0,0,0,0,0,0,29
28,0,0,0,0,0,0,0,0,0,0,0,0,0,0,0,0,0,0,29
41,30,30,30,30,30,30,30,30,30,30,30,30,30,30,30,30,30,30,41
