50 50
d_big_arena_entities.csv
41,41,41,41,41,41,41,41,41,41,41,41,41,41,41,41,41,19,19,19,19,19,19,19,19,19,19,19,19,19,19,19,19,41,41,41,41,41,41,41,41,41,41,41,41,41,41,41,41,41
41,41,41,41,41,41,41,41,41,41,41,41,41,41,41,41,19,19,19,19,19,19,19,19,19,19,19,19,19,19,19,19,19,19,19,41,41,41,41,41,41,41,41,41,41,41,41,41,41,41
41,41,41,41,41,41,41,41,41,41,41,41,41,41,41,19,19,19,19,19,19,19,19,19,19,19,19,19,19,19,19,19,19,19,19,19,19,19,19,19,41,41,41,41,41,41,41,41,41,41
41,41,41,41,41,41,41,41,41,41,41,41,41,19,19,19,19,19,19,19,19,19,19,19,19,19,19,19,19,19,19,19,19,19,19,19,19,19,19,19,19,19,19,19,41,41,41,41,41,41
41,41,41,41,41,41,41,41,41,41,41,19,19,19,19,19,19,19,19,19,19,19,19,19,19,19,19,19,19,19,19,19,19,19,19,19,19,19,19,19,19,19,19,19,41,41,41,41,41,41
41,41,41,41,41,41,41,41,41,19,19,19,19,19,19,19,19,19,19,19,19,19,19,19,19,19,19,19,19,19,19,19,19,19,19,19,19,19,19,19,19,19,19,19,19,41,41,41,41,41
41,41,41,41,41,41,41,41,19,19,19,19,19,19,19,19,19,19,19,19,19,19,19,19,19,19,19,19,19,19,19,19,19,19,19,19,19,19,19,19,19,19,19,19,19,41,41,41,41,41
41,41,41,41,41,41,41,19,19,19,19,19,19,19,19,19,19,19,19,19,19,19,19,19,19,19,19,19,19,19,19,19,19,19,19,19,19,19,19,19,19,19,19,19,19,41,41,41,41,41
41,41,41,41,41,41,19,19,19,19,19,19,19,19,19,19,19,19,19,19,19,19,19,19,19,19,19,19,19,19,19,19,19,19,19,19,19,19,19,19,19,19,19,19,19,41,41,41,41,41
41,41,41,41,19,19,19,19,19,19,19,19,19,19,19,19,19,19,19,19,19,19,19,19,19,19,19,19,19,19,19,19,19,19,19,19,19,19,19,19,19,19,19,19,19,41,41,41,41,41
41,41,19,19,19,19,19,19,19,19,19,19,19,19,19,19,19,19,19,19,19,19,19,19,19,19,19,19,19,19,19,19,19,19,19,19,19,19,19,19,19,19,19,19,19,41,41,41,41,41
19,19,19,19,19,19,19,19,19,19,19,19,19,19,19,19,19,19,19,19,19,19,19,19,19,19,19,19,19,19,19,19,19,19,19,19,19,19,19,19,19,19,19,19,19,41,41,41,41,41
19,19,19,19,19,19,19,19,19,19,19,19,19,19,19,19,20,20,20,20,20,20,20,20,20,20,20,20,20,20,20,20,20,19,19,19,19,19,19,19,19,19,19,19,19,19,19,19,19,19
19,19,19,19,19,19,19,19,19,19,19,19,19,19,20,20,20,20,20,20,20,20,20,20,20,20,20,20,20,20,20,20,20,20,20,19,19,19,19,19,19,19,19,19,19,19,19,19,19,19
19,19,19,19,19,19,19,19,19,19,20,20,20,20,20,20,20,20,20,20,20,20,20,20,20,20,20,20,20,20,20,20,20,20,20,20,20,19,19,19,19,19,19,19,19,19,19,19,19,19
19,19,19,19,19,19,19,19,19,19,20,20,20,20,20,20,20,20,20,20,20,20,20,20,20,20,20,20,20,20,20,20,20,20,20,20,20,20,20,19,19,19,19,19,19,19,19,19,19,19
19,19,19,19,19,19,19,19,19,19,20,20,20,20,20,20,20,20,20,20,20,20,20,20,20,20,20,20,20,20,20,20,20,20,20,20,20,20,20,19,19,19,19,19,19,19,19,19,19,19
19,19,19,19,19,19,19,19,19,20,20,20,20,20,20,20,20,20,20,20,20,20,20,20,20,20,20,20,20,20,20,20,20,20,20,20,20,20,20,20,19,19,19,19,19,19,19,19,19,19
19,19,19,19,19,19,19,19,20,20,20,20,20,20,20,20,20,20,20,20,7,7,7,7,7,7,7,7,7,20,20,20,20,20,20,20,20,20,20,20,19,19,19,19,19,19,19,19,19,19
19,19,19,19,19,19,19,19,20,20,20,20,20,20,20,20,20,20,7,7,7,7,7,7,7,7,7,7,7,7,7,20,20,20,20,20,20,20,20,20,19,19,19,19,19,19,19,19,19,19
19,19,19,19,19,19,19,19,20,20,20,20,20,20,20,20,20,20,7,7,7,7,7,7,7,7,7,7,7,7,7,7,20,20,20,20,20,20,20,20,19,19,19,19,19,19,19,19,19,19
19,19,19,19,19,19,19,19,20,20,20,20,20,20,20,20,20,7,7,7,7,7,7,7,7,7,7,7,7,7,7,7,7,20,20,20,20,20,20,20,19,19,19,19,19,19,19,19,19,19
19,19,19,19,19,19,19,19,20,20,20,20,20,20,20,20,7,7,7,7,7,7,7,7,7,7,7,7,7,7,7,7,7,7,20,20,20,20,20,20,20,19,19,19,19,19,19,19,19,19
19,19,19,19,19,19,19,19,20,20,20,20,20,20,20,20,7,7,7,7,7,7,7,7,7,7,7,7,7,7,7,7,7,7,7,20,20,20,20,20,20,19,19,19,19,19,19,19,19,19
19,19,19,19,19,19,19,19,20,20,20,20,20,20,20,20,7,7,7,7,7,7,7,7,7,7,7,7,7,7,7,7,7,7,7,20,20,20,20,20,20,19,19,19,19,19,19,19,19,19
19,19,19,19,19,19,19,19,20,20,20,20,20,20,20,7,7,7,7,7,7,7,7,7,7,7,7,7,7,7,7,7,7,7,7,20,20,20,20,20,20,19,19,19,19,19,19,19,19,19
19,19,19,19,19,19,19,19,20,20,20,20,20,20,20,7,7,7,7,7,7,7,7,7,7,7,7,7,7,7,7,7,7,7,7,20,20,20,20,20,20,19,19,19,19,19,19,19,19,19
19,19,19,19,19,19,19,19,20,20,20,20,20,20,20,7,7,7,7,7,7,7,7,7,7,7,7,7,7,7,7,7,7,7,20,20,20,20,20,20,20,19,19,19,19,19,19,19,19,19
19,19,19,19,19,19,19,19,20,20,20,20,20,20,20,7,7,7,7,7,7,7,7,7,7,7,7,7,7,7,7,7,7,7,20,20,20,20,20,20,19,19,19,19,19,19,19,19,19,19
19,19,19,19,19,19,19,19,20,20,20,20,20,20,20,20,7,7,7,7,7,7,7,7,7,7,7,7,7,7,7,7,7,20,20,20,20,20,20,20,19,19,19,19,19,19,19,19,19,19
19,19,19,19,19,19,19,19,20,20,20,20,20,20,20,20,7,7,7,7,7,7,7,7,7,7,7,7,7,7,7,7,7,20,20,20,20,20,20,20,19,19,19,19,19,19,19,19,19,19
19,19,19,19,19,19,19,19,20,20,20,20,20,20,20,20,7,7,7,7,7,7,7,7,7,7,7,7,7,7,7,7,20,20,20,20,20,20,20,20,19,19,19,19,19,19,19,19,19,19
19,19,19,19,19,19,19,19,20,20,20,20,20,20,20,20,20,20,7,7,7,7,7,7,7,7,7,7,7,7,7,7,20,20,20,20,20,20,20,20,19,19,19,19,19,19,19,19,19,19
19,19,19,19,19,19,19,19,20,20,20,20,20,20,20,20,20,20,20,20,7,7,7,7,7,7,7,7,7,7,7,20,20,20,20,20,20,20,20,19,19,19,19,19,19,19,19,19,19,19
19,19,19,19,19,19,19,19,20,20,20,20,20,20,20,20,20,20,20,20,20,20,7,7,7,7,7,7,7,7,20,20,20,20,20,20,20,20,20,19,19,19,19,19,19,19,19,19,19,19
19,19,19,19,19,19,19,19,19,20,20,20,20,20,20,20,20,20,20,20,20,20,20,20,20,7,7,7,20,20,20,20,20,20,20,20,20,20,20,19,19,19,19,19,19,19,19,19,19,19
19,19,19,19,19,19,19,19,19,20,20,20,20,20,20,20,20,20,20,20,20,20,20,20,20,20,20,20,20,20,20,20,20,20,20,20,20,20,19,19,19,19,19,19,19,19,19,19,19,19
19,19,19,19,19,19,19,19,19,19,20,20,20,20,20,20,20,20,20,20,20,20,20,20,20,20,20,20,20,20,20,20,20,20,20,20,20,20,19,19,19,19,19,19,19,19,19,19,19,19
19,19,19,19,19,19,19,19,19,19,20,20,20,20,20,20,20,20,20,20,20,20,20,20,20,20,20,20,20,20,20,20,20,20,20,20,20,19,19,19,19,19,19,19,19,19,19,19,19,19
19,19,19,19,19,19,19,19,19,19,19,20,20,20,20,20,20,20,20,20,20,20,20,20,20,20,20,20,20,20,20,20,20,20,20,20,20,19,19,19,19,19,19,19,19,19,19,19,19,19
19,19,19,19,19,19,19,19,19,19,19,19,19,19,20,20,20,20,20,20,20,20,20,20,20,20,20,20,20,20,20,20,20,20,20,20,19,19,19,19,19,19,19,19,19,19,19,19,19,19
19,19,19,19,19,19,19,19,19,19,19,19,19,19,19,19,19,20,20,20,20,20,20,20,20,20,20,20,20,20,20,20,20,20,19,19,19,19,19,19,19,19,19,19,19,19,19,19,19,19
41,19,19,19,19,19,19,19,19,19,19,19,19,19,19,19,19,19,19,20,20,20,20,20,20,19,19,19,19,19,19,19,19,19,19,19,19,19,19,19,19,19,19,19,19,19,19,19,19,41
41,41,19,19,19,19,19,19,19,19,19,19,19,19,19,19,19,19,19,19,19,19,19,19,19,19,19,19,19,19,19,19,19,19,19,19,19,19,19,19,19,19,19,19,19,19,19,19,19,41
41,41,41,41,19,19,19,19,19,19,19,19,19,19,19,19,19,19,19,19,19,19,19,19,19,19,19,19,19,19,19,19,19,19,19,19,19,19,19,19,19,19,19,19,19,19,19,41,41,41
41,41,41,41,19,19,19,19,19,19,19,19,19,19,19,19,19,19,19,19,19,19,19,19,19,19,19,19,19,19,19,19,19,19,19,19,19,19,19,19,19,19,19,19,19,41,41,41,41,41
41,41,41,41,41,19,19,19,19,19,19,19,19,19,19,19,19,19,19,19,19,19,19,19,19,19,19,19,19,19,19,19,19,19,19,19,19,19,19,19,19,19,19,41,41,41,41,41,41,41
41,41,41,41,41,41,19,19,19,19,19,19,19,19,19,19,19,19,19,19,19,19,19,19,19,19,19,19,19,19,19,19,19,19,19,19,19,19,19,19,19,19,41,41,41,41,41,41,41,41
41,41,41,41,41,41,41,41,19,19,19,19,19,19,19,19,19,19,19,19,19,19,19,19,19,19,19,19,19,19,19,19,19,19,19,19,19,19,19,19,19,41,41,41,41,41,41,41,41,41
41,41,41,41,41,41,41,41,41,19,19,19,19,19,19,19,19,19,19,19,19,19,19,19,19,19,19,19,19,19,19,19,19,19,19,19,19,19,19,19,41,41,41,41,41,41,41,41,41,41
