6 6
dungeon_goblin_1_entities.csv
2,3,3,3,2,3
2,3,3,3,3,3
3,3,3,3,3,3
2,3,3,3,3,3
3,3,3,3,3,3
3,3,3,3,3,2
