10 10
dungeon_spider_v1_entities.csv
35,35,35,36,35,35,35,35,35,35
35,35,19,35,35,20,35,35,35,35
35,18,20,20,19,19,16,17,36,35
35,31,19,20,19,19,19,32,19,35
20,20,19,19,19,19,20,32,35,35
36,20,20,19,19,19,19,32,35,35
35,33,31,19,19,19,19,19,20,35
35,20,19,19,19,19,19,20,35,35
35,36,35,19,35,35,36,35,35,35
35,35,35,35,35,35,35,35,35,35
