9 9
spawn_area_entities.csv
10,10,8,9,9,9,8,10,10
10,8,8,8,8,8,8,8,10
8,8,8,8,8,8,8,8,8
9,8,8,8,8,8,8,8,9
9,8,8,8,8,8,8,8,9
9,8,8,8,8,8,8,8,9
8,8,8,8,8,8,8,8,8
10,8,8,8,8,8,8,8,10
10,10,8,9,9,9,8,10,10
