25 25
boss_arena_entities.csv
21,18,16,16,16,16,16,16,16,16,16,16,16,16,16,16,16,16,16,16,16,16,16,17,22
21,33,31,31,31,31,31,31,31,31,31,31,31,31,31,31,31,31,31,31,31,31,31,32,22
21,19,19,20,20,19,19,19,19,19,19,19,19,19,19,19,19,19,20,20,19,19,19,19,22
21,19,19,20,20,19,19,19,19,19,19,19,19,19,19,19,19,19,20,20,19,19,19,19,22
21,19,19,19,19,19,19,19,19,19,19,19,19,19,19,19,19,19,19,19,19,19,19,19,22
21,19,19,19,19,19,19,19,19,19,19,19,19,19,19,19,19,19,19,19,19,19,19,19,22
21,19,19,19,19,19,19,19,19,19,19,19,19,19,19,19,19,19,19,19,19,19,19,19,22
21,19,19,19,19,19,19,19,19,19,19,19,19,19,19,19,19,19,19,19,19,19,19,20,22
21,19,19,19,19,19,19,19,19,19,19,19,19,19,19,19,19,19,19,19,19,19,19,20,22
21,19,19,19,19,19,19,19,19,19,19,19,19,19,19,19,19,19,19,19,19,19,19,20,22
21,19,19,19,19,19,19,19,19,19,19,19,19,19,19,2,19,19,19,19,19,19,19,20,22
21,19,19,19,19,19,19,19,19,19,19,19,19,19,19,19,19,19,19,19,19,19,19,19,22
21,19,19,20,20,19,19,19,19,19,19,19,19,20,20,19,19,19,19,19,19,19,19,19,22
21,19,19,20,20,19,19,19,19,19,19,19,19,20,20,19,19,19,19,19,19,20,20,19,22
21,19,19,19,19,19,19,19,19,19,19,19,19,19,19,19,19,19,19,19,19,20,20,19,22
21,19,19,19,19,19,19,19,19,19,19,19,19,19,19,19,19,19,19,19,19,19,19,19,22
21,19,19,19,19,19,19,19,19,19,19,19,19,19,19,19,19,19,19,19,19,19,19,19,22
21,19,19,19,19,19,19,19,19,19,19,19,19,19,19,19,19,19,19,19,19,19,19,19,22
21,19,19,19,19,19,19,19,19,19,19,19,19,19,19,19,19,19,19,19,19,19,19,19,22
21,19,19,19,19,19,19,19,20,20,19,19,19,19,19,19,19,19,19,19,19,20,20,20,22
21,19,19,19,19,19,19,19,20,20,19,19,19,19,19,19,19,19,19,19,19,20,20,20,22
21,19,19,19,19,20,20,19,19,19,19,19,19,19,19,19,19,19,19,19,19,19,19,19,22
21,19,19,19,19,20,20,19,19,19,19,19,19,19,19,19,19,19,19,19,19,19,19,19,22
23,16,16,16,16,16,16,16,16,16,16,16,16,16,16,16,16,16,16,16,16,16,16,16,24
23,31,31,31,31,31,31,31,31,31,31,31,31,31,31,31,31,31,31,31,31,31,31,31,24
