10 10
map1_entities.csv
-1,27,27,27,27,27,27,27,27,-1
28,0,1,0,0,0,0,1,0,29
28,0,0,0,1,0,0,0,0,29
28,0,0,0,0,0,0,0,0,29
28,0,1,0,0,0,0,0,0,29
28,0,0,0,0,0,0,1,0,29
28,0,0,0,0,0,0,0,0,29
28,0,0,1,0,0,0,1,0,29
28,0,0,0,0,0,0,0,0,29
-1,30,30,30,30,30,30,30,30,-1
